8 5
....XXX.
......X.
....XXX.
....X...
....XXX.

.XXX....
.X......
.XXX....
...X....
.XXX....
