8 5
......X.
......X.
......X.
........
......X.

.XXX....
.X.X....
..XX....
........
..X.....
