8 5
....XXX.
....X...
....XXX.
....X...
....X...

.XXX....
..X.....
..X.....
..X.....
..X.....
